.#.########
...#.#.####
.#...###..#
.#.........
#...#..#..#
.##..###..#
.....#....#
.##.##.#.##
.##..@...#
.##.#..#.
.#######