###########
#@#..#....#
#.#.####.##
#.#......##
#......#..#
###..###.##
#....#...##
#.#.##.#.##
##.#....#.#
#.........#
#.#########